111111111111111111
100000000001000001
100111110Z00000001
100100000001111001
1C0100000001110001
111100001101E10001
100000001001B00001
1000P0101001110001
111111111111111111
