111111111111111
10B0B0100000001
101E10100000001
101110000000001
1000Z0000111001
100000111100001
10000000C10P001
111111111111111
