111111111111111111111111
100000100000001000000P01
101C10100000001000000001
101110000000001100000001
100000000000000111110001
100000000000000100000001
100000000000000100000001
10000Z001000000100B00001
100000001011111100000001
100000001000000100000001
100000001111110100011101
100000111000000000000001
100000BE1000000000000001
111111111111111111111111
