111111111111111111
100000000000000001
1000000C0010000C01
100011111110000001
100000000000000001
100000C00000000001
100000000000011B11
100000P000000100E1
111111111111111111
