111111111111111111111111
1000000000000Z0110110001
10C000000000000000011111
100000000000000000011111
111000000000000000011111
100010000000000000011111
100010011111111110011111
100000011111111110011011
101000011111111110001111
1C100Z01111EE11110000111
111100010000000000000011
1111000000000000Z0000001
100000000100001000000111
100000000000000000000001
100000000000000000000001
100000000000000000000001
111111111000000111111111
100000000000000000000001
100000000000000000000001
101111101000000101111101
1000000000000000000000C1
100000000000000000000Z01
100Z000000000P0000000001
111111111111111111111111
