11111
1Z001
10001
100P1
11111
